#####
#.#.#
#...#
#.#.#
###.#

\robot 1 1
\robot 4 0
