#........######
#..##.........#
#..##.........#
#.............#
#...#...#.....#
#...#...#.....#
#...#####.....#
#.............#
#.............#
#.....#.......#
#....#.#......#
#.....#.......#
#.............#
#.............#
#.#.#.#.#.#####

\robot 1 0
\robot 8 2
\robot 9 5
\robot 12 12
