###..###
#......#
#..#...#
#...#..#
#..#...#
#...#..#
#..#...#
#...#..#
\robot 1 0
\robot 2 0
\robot 5 0
